HHHHHHHHHHHHHHHHHHHHHHHHHHHHHHHHHHHHHHHHHH
H # # # #  == H H H | | H ==== H H H H H H
H# ======= HH-H-H-H     H      H-H-H-H-H-H
H  =====  HHH            H               H
H# ===  HH  H  =  =      H       = = = = H
H      HH   HHHHHHHHHHHHH-HHH-HHHHHHHHHHHH
HHHH-HH                =       =         H
  H                                      H
HHH                                      H
H                                        H
H                                        H
H                                        H
HH HH HH  -- HH HHHHHHHHHHHHHHHHHHHHHHHHHH






