ＨＨＨＨＨＨＨＨＨＨＨＨＨＨＨＨＨＨＨＨＨＨＨＨＨＨＨＨＨＨＨＨＨＨＨＨＨＨＨＨＨＨ
Ｈ　＃　＃　＃　＃　　＝＝　Ｈ　Ｈ　Ｈ　｜　｜　Ｈ　＝＝＝＝　Ｈ　Ｈ　Ｈ　Ｈ　Ｈ　Ｈ
Ｈ＃　＝＝＝＝＝＝＝　ＨＨ－Ｈ－Ｈ－Ｈ　　　　　Ｈ　　　　　　Ｈ－Ｈ－Ｈ－Ｈ－Ｈ－Ｈ
Ｈ　　＝＝＝＝＝　　ＨＨＨ　　　　　　　　　　　　Ｈ　　　　　　　　　　　　　　　Ｈ
Ｈ＃　＝＝＝　　ＨＨ　　Ｈ　　＝　　＝　　　　　　Ｈ　　　　　　　＝　＝　＝　＝　Ｈ
Ｈ　　　　　　ＨＨ　　　ＨＨＨＨＨＨＨＨＨＨＨＨＨ－ＨＨＨ－ＨＨＨＨＨＨＨＨＨＨＨＨ
ＨＨＨＨ－ＨＨ　　　　　　　　　　　　　　　　＝　　　　　　　＝　　　　　　　　　Ｈ
　　Ｈ　　　　　　　　　　　　　　　　　　　　　　　　　　　　　　　　　　　　　　Ｈ
ＨＨＨ　　　　　　　　　　　　　　　　　　　　　　　　　　　　　　　　　　　　　　Ｈ
Ｈ　　　　　　　　　　　　　　　　　　　　　　　　　　　　　　　　　　　　　　　　Ｈ
Ｈ　　　　　　　　　　　　　　　　　　　　　　　　　　　　　　　　　　　　　　　　Ｈ
Ｈ　　　　　　　　　　　　　　　　　　　　　　　　　　　　　　　　　　　　　　　　Ｈ
ＨＨ　ＨＨ　ＨＨ　　－－　ＨＨ　ＨＨＨＨＨＨＨＨＨＨＨＨＨＨＨＨＨＨＨＨＨＨＨＨＨＨ






